Jahr;Monat;Branche_Code;Branche_Label;Arbeitnehmer;Eröffnet;Abgelehnt;Total
2013;1;WZ08-56;Bars & Clubs;202;62;21;83
2013;2;WZ08-56;Bars & Clubs;204;65;14;79
2013;3;WZ08-56;Bars & Clubs;127;70;15;85
2013;4;WZ08-56;Bars & Clubs;146;60;19;79
2013;5;WZ08-56;Bars & Clubs;91;37;11;48
2013;7;WZ08-56;Bars & Clubs;93;37;15;52
2013;8;WZ08-56;Bars & Clubs;175;57;4;61
2013;9;WZ08-56;Bars & Clubs;98;45;17;62
2013;10;WZ08-56;Bars & Clubs;105;44;15;59
2013;11;WZ08-56;Bars & Clubs;78;59;13;72
2013;12;WZ08-56;Bars & Clubs;58;42;14;56
2013;1;WZ08-56;Caterer;42;11;1;12
2013;2;WZ08-56;Caterer;17;12;2;14
2013;3;WZ08-56;Caterer;43;11;4;15
2013;4;WZ08-56;Caterer;30;12;2;14
2013;5;WZ08-56;Caterer;514;8;4;12
2013;7;WZ08-56;Caterer;51;11;7;18
2013;8;WZ08-56;Caterer;93;15;7;22
2013;9;WZ08-56;Caterer;64;10;1;11
2013;10;WZ08-56;Caterer;24;9;4;13
2013;11;WZ08-56;Caterer;31;6;4;10
2013;12;WZ08-56;Caterer;47;8;2;10
2013;1;WZ08-55;Hotels;264;41;15;56
2013;2;WZ08-55;Hotels;479;26;8;34
2013;3;WZ08-55;Hotels;182;54;9;63
2013;4;WZ08-55;Hotels;209;44;23;67
2013;5;WZ08-55;Hotels;1284;38;0;38
2013;7;WZ08-55;Hotels;450;47;10;57
2013;8;WZ08-55;Hotels;92;32;9;41
2013;9;WZ08-55;Hotels;283;40;12;52
2013;10;WZ08-55;Hotels;179;30;8;38
2013;11;WZ08-55;Hotels;234;46;6;52
2013;12;WZ08-55;Hotels;99;17;11;28
2013;1;WZ08-56;Restaurants & Cafes;1143;380;108;488
2013;2;WZ08-56;Restaurants & Cafes;918;304;73;377
2013;3;WZ08-56;Restaurants & Cafes;769;310;97;407
2013;4;WZ08-56;Restaurants & Cafes;1141;323;87;410
2013;5;WZ08-56;Restaurants & Cafes;1224;327;99;426
2013;7;WZ08-56;Restaurants & Cafes;1494;448;61;509
2013;8;WZ08-56;Restaurants & Cafes;1072;312;110;422
2013;9;WZ08-56;Restaurants & Cafes;993;273;94;367
2013;10;WZ08-56;Restaurants & Cafes;1289;316;105;421
2013;11;WZ08-56;Restaurants & Cafes;1083;282;75;357
2013;12;WZ08-56;Restaurants & Cafes;1237;235;91;326
2014;1;WZ08-56;Bars & Clubs;189;47;15;62
2014;2;WZ08-56;Bars & Clubs;122;40;20;60
2014;3;WZ08-56;Bars & Clubs;139;52;19;71
2014;4;WZ08-56;Bars & Clubs;139;52;19;71
2014;5;WZ08-56;Bars & Clubs;50;42;9;51
2014;6;WZ08-56;Bars & Clubs;50;30;2;32
2014;7;WZ08-56;Bars & Clubs;187;63;13;76
2014;8;WZ08-56;Bars & Clubs;196;54;19;73
2014;9;WZ08-56;Bars & Clubs;141;53;9;62
2014;10;WZ08-56;Bars & Clubs;53;28;14;42
2014;11;WZ08-56;Bars & Clubs;76;41;8;49
2014;12;WZ08-56;Bars & Clubs;169;31;22;53
2014;1;WZ08-56;Caterer;39;12;2;14
2014;2;WZ08-56;Caterer;315;8;3;11
2014;3;WZ08-56;Caterer;66;13;2;15
2014;4;WZ08-56;Caterer;66;13;2;15
2014;5;WZ08-56;Caterer;106;11;4;15
2014;6;WZ08-56;Caterer;45;8;;8
2014;7;WZ08-56;Caterer;44;10;7;17
2014;8;WZ08-56;Caterer;27;8;2;10
2014;9;WZ08-56;Caterer;4;3;1;4
2014;10;WZ08-56;Caterer;121;7;3;10
2014;11;WZ08-56;Caterer;45;13;1;14
2014;12;WZ08-56;Caterer;45;9;5;14
2014;1;WZ08-55;Hotels;124;19;5;24
2014;2;WZ08-55;Hotels;80;39;6;45
2014;3;WZ08-55;Hotels;386;49;3;52
2014;4;WZ08-55;Hotels;386;49;3;52
2014;5;WZ08-55;Hotels;184;12;3;15
2014;6;WZ08-55;Hotels;228;22;11;33
2014;7;WZ08-55;Hotels;484;30;14;44
2014;8;WZ08-55;Hotels;210;21;;21
2014;9;WZ08-55;Hotels;72;27;5;32
2014;10;WZ08-55;Hotels;40;20;3;23
2014;11;WZ08-55;Hotels;163;26;19;45
2014;12;WZ08-55;Hotels;197;36;3;39
2014;1;WZ08-56;Restaurants & Cafes;1981;302;72;374
2014;2;WZ08-56;Restaurants & Cafes;1100;290;97;387
2014;3;WZ08-56;Restaurants & Cafes;1101;295;90;385
2014;4;WZ08-56;Restaurants & Cafes;1101;295;90;385
2014;5;WZ08-56;Restaurants & Cafes;1387;317;111;428
2014;6;WZ08-56;Restaurants & Cafes;726;244;70;314
2014;7;WZ08-56;Restaurants & Cafes;793;287;133;420
2014;8;WZ08-56;Restaurants & Cafes;923;294;135;429
2014;9;WZ08-56;Restaurants & Cafes;1313;316;86;402
2014;10;WZ08-56;Restaurants & Cafes;1720;362;120;482
2014;11;WZ08-56;Restaurants & Cafes;916;300;109;409
2014;12;WZ08-56;Restaurants & Cafes;1412;304;100;404
2015;1;WZ08-56;Bars & Clubs;176;51;25;76
2015;2;WZ08-56;Bars & Clubs;254;65;16;81
2015;3;WZ08-56;Bars & Clubs;119;43;17;60
2015;4;WZ08-56;Bars & Clubs;25;40;4;44
2015;5;WZ08-56;Bars & Clubs;50;42;14;56
2015;6;WZ08-56;Bars & Clubs;144;57;25;82
2015;7;WZ08-56;Bars & Clubs;72;63;19;82
2015;8;WZ08-56;Bars & Clubs;25;28;10;38
2015;9;WZ08-56;Bars & Clubs;108;40;7;47
2015;10;WZ08-56;Bars & Clubs;115;40;12;52
2015;11;WZ08-56;Bars & Clubs;80;43;18;61
2015;12;WZ08-56;Bars & Clubs;54;55;9;64
2015;1;WZ08-56;Caterer;157;7;2;9
2015;2;WZ08-56;Caterer;40;8;5;13
2015;3;WZ08-56;Caterer;6;9;4;13
2015;4;WZ08-56;Caterer;58;8;8;16
2015;5;WZ08-56;Caterer;34;9;4;13
2015;6;WZ08-56;Caterer;18;8;2;10
2015;7;WZ08-56;Caterer;72;13;2;15
2015;8;WZ08-56;Caterer;41;3;1;4
2015;9;WZ08-56;Caterer;87;7;3;10
2015;10;WZ08-56;Caterer;29;11;2;13
2015;11;WZ08-56;Caterer;30;6;3;9
2015;12;WZ08-56;Caterer;13;7;3;10
2015;1;WZ08-55;Hotels;87;23;12;35
2015;2;WZ08-55;Hotels;355;47;9;56
2015;3;WZ08-55;Hotels;413;40;6;46
2015;4;WZ08-55;Hotels;585;60;8;68
2015;5;WZ08-55;Hotels;357;22;2;24
2015;6;WZ08-55;Hotels;500;36;17;53
2015;7;WZ08-55;Hotels;258;27;7;34
2015;8;WZ08-55;Hotels;198;37;5;42
2015;9;WZ08-55;Hotels;37;17;6;23
2015;10;WZ08-55;Hotels;316;37;6;43
2015;11;WZ08-55;Hotels;136;23;26;49
2015;12;WZ08-55;Hotels;252;36;11;47
2015;1;WZ08-56;Restaurants & Cafes;1550;275;90;365
2015;2;WZ08-56;Restaurants & Cafes;1462;282;72;354
2015;3;WZ08-56;Restaurants & Cafes;1133;302;83;385
2015;4;WZ08-56;Restaurants & Cafes;1059;262;83;345
2015;5;WZ08-56;Restaurants & Cafes;699;258;89;347
2015;6;WZ08-56;Restaurants & Cafes;1007;364;84;448
2015;7;WZ08-56;Restaurants & Cafes;1363;309;108;417
2015;8;WZ08-56;Restaurants & Cafes;933;365;78;443
2015;9;WZ08-56;Restaurants & Cafes;1124;303;66;369
2015;10;WZ08-56;Restaurants & Cafes;1309;342;90;432
2015;11;WZ08-56;Restaurants & Cafes;1060;293;107;400
2015;12;WZ08-56;Restaurants & Cafes;1355;313;92;405
2016;1;WZ08-56;Bars & Clubs;94;38;4;42
2016;2;WZ08-56;Bars & Clubs;102;40;17;57
2016;3;WZ08-56;Bars & Clubs;58;22;16;38
2016;4;WZ08-56;Bars & Clubs;18;57;23;80
2016;5;WZ08-56;Bars & Clubs;137;37;16;53
2016;6;WZ08-56;Bars & Clubs;171;45;20;65
2016;7;WZ08-56;Bars & Clubs;71;45;12;57
2016;8;WZ08-56;Bars & Clubs;98;37;21;58
2016;9;WZ08-56;Bars & Clubs;29;41;16;57
2016;10;WZ08-56;Bars & Clubs;47;51;8;59
2016;11;WZ08-56;Bars & Clubs;125;37;19;56
2016;12;WZ08-56;Bars & Clubs;63;32;14;46
2016;1;WZ08-56;Caterer;48;10;3;13
2016;2;WZ08-56;Caterer;2;7;3;10
2016;3;WZ08-56;Caterer;139;9;4;13
2016;4;WZ08-56;Caterer;12;9;7;16
2016;5;WZ08-56;Caterer;28;6;4;10
2016;6;WZ08-56;Caterer;35;12;6;18
2016;7;WZ08-56;Caterer;12;13;7;20
2016;8;WZ08-56;Caterer;106;18;3;21
2016;9;WZ08-56;Caterer;109;11;5;16
2016;10;WZ08-56;Caterer;59;8;2;10
2016;11;WZ08-56;Caterer;27;8;6;14
2016;12;WZ08-56;Caterer;120;12;2;14
2016;1;WZ08-55;Hotels;23;11;6;17
2016;2;WZ08-55;Hotels;177;29;;29
2016;3;WZ08-55;Hotels;27;15;3;18
2016;4;WZ08-55;Hotels;502;30;9;39
2016;5;WZ08-55;Hotels;124;30;12;42
2016;6;WZ08-55;Hotels;290;30;9;39
2016;7;WZ08-55;Hotels;147;29;6;35
2016;8;WZ08-55;Hotels;280;26;9;35
2016;9;WZ08-55;Hotels;336;33;6;39
2016;10;WZ08-55;Hotels;224;24;;24
2016;11;WZ08-55;Hotels;172;24;3;27
2016;12;WZ08-55;Hotels;;23;5;28
2016;1;WZ08-56;Restaurants & Cafes;1055;318;95;413
2016;2;WZ08-56;Restaurants & Cafes;882;283;81;364
2016;3;WZ08-56;Restaurants & Cafes;1154;329;70;399
2016;4;WZ08-56;Restaurants & Cafes;840;358;96;454
2016;5;WZ08-56;Restaurants & Cafes;624;251;90;341
2016;6;WZ08-56;Restaurants & Cafes;1809;374;91;465
2016;7;WZ08-56;Restaurants & Cafes;1230;338;105;443
2016;8;WZ08-56;Restaurants & Cafes;1317;299;96;395
2016;9;WZ08-56;Restaurants & Cafes;1154;320;81;401
2016;10;WZ08-56;Restaurants & Cafes;841;261;63;324
2016;11;WZ08-56;Restaurants & Cafes;835;304;128;432
2016;12;WZ08-56;Restaurants & Cafes;1612;286;65;351
2017;1;WZ08-56;Bars & Clubs;116;33;29;62
2017;2;WZ08-56;Bars & Clubs;122;43;16;59
2017;3;WZ08-56;Bars & Clubs;135;40;18;58
2017;4;WZ08-56;Bars & Clubs;100;18;17;35
2017;5;WZ08-56;Bars & Clubs;143;40;13;53
2017;6;WZ08-56;Bars & Clubs;43;36;15;51
2017;7;WZ08-56;Bars & Clubs;96;28;13;41
2017;8;WZ08-56;Bars & Clubs;70;34;17;51
2017;9;WZ08-56;Bars & Clubs;117;24;8;32
2017;10;WZ08-56;Bars & Clubs;100;48;15;63
2017;11;WZ08-56;Bars & Clubs;62;19;26;45
2017;12;WZ08-56;Bars & Clubs;32;36;3;39
2017;1;WZ08-56;Caterer;51;8;2;10
2017;2;WZ08-56;Caterer;54;15;2;17
2017;3;WZ08-56;Caterer;99;12;6;18
2017;4;WZ08-56;Caterer;28;5;2;7
2017;5;WZ08-56;Caterer;63;12;3;15
2017;6;WZ08-56;Caterer;50;11;4;15
2017;7;WZ08-56;Caterer;7;7;4;11
2017;8;WZ08-56;Caterer;;6;;6
2017;9;WZ08-56;Caterer;159;12;2;14
2017;10;WZ08-56;Caterer;58;10;2;12
2017;11;WZ08-56;Caterer;516;14;2;16
2017;12;WZ08-56;Caterer;66;10;3;13
2017;1;WZ08-55;Hotels;;15;18;33
2017;2;WZ08-55;Hotels;81;14;;14
2017;3;WZ08-55;Hotels;403;35;11;46
2017;4;WZ08-55;Hotels;10;10;11;21
2017;5;WZ08-55;Hotels;139;24;8;32
2017;6;WZ08-55;Hotels;273;34;8;42
2017;7;WZ08-55;Hotels;438;40;12;52
2017;8;WZ08-55;Hotels;245;26;12;38
2017;9;WZ08-55;Hotels;90;20;6;26
2017;10;WZ08-55;Hotels;76;35;;35
2017;11;WZ08-55;Hotels;63;23;3;26
2017;12;WZ08-55;Hotels;141;33;8;41
2017;1;WZ08-56;Restaurants & Cafes;881;280;75;355
2017;2;WZ08-56;Restaurants & Cafes;1430;303;66;369
2017;3;WZ08-56;Restaurants & Cafes;974;279;66;345
2017;4;WZ08-56;Restaurants & Cafes;777;224;94;318
2017;5;WZ08-56;Restaurants & Cafes;1068;307;82;389
2017;6;WZ08-56;Restaurants & Cafes;1095;254;77;331
2017;7;WZ08-56;Restaurants & Cafes;845;245;78;323
2017;8;WZ08-56;Restaurants & Cafes;1118;278;113;391
2017;9;WZ08-56;Restaurants & Cafes;896;250;89;339
2017;10;WZ08-56;Restaurants & Cafes;919;245;72;317
2017;11;WZ08-56;Restaurants & Cafes;1969;308;99;407
2017;12;WZ08-56;Restaurants & Cafes;806;211;90;301
2018;1;WZ08-56;Bars & Clubs;14;23;12;35
2018;2;WZ08-56;Bars & Clubs;64;28;14;42
2018;3;WZ08-56;Bars & Clubs;129;24;21;45
2018;4;WZ08-56;Bars & Clubs;56;25;20;45
2018;5;WZ08-56;Bars & Clubs;210;40;17;57
2018;6;WZ08-56;Bars & Clubs;115;33;16;49
2018;7;WZ08-56;Bars & Clubs;97;38;24;62
2018;8;WZ08-56;Bars & Clubs;178;44;1;45
2018;9;WZ08-56;Bars & Clubs;160;28;13;41
2018;10;WZ08-56;Bars & Clubs;127;36;13;49
2018;11;WZ08-56;Bars & Clubs;82;52;15;67
2018;12;WZ08-56;Bars & Clubs;114;26;17;43
2018;1;WZ08-56;Caterer;94;7;6;13
2018;2;WZ08-56;Caterer;22;9;3;12
2018;3;WZ08-56;Caterer;85;8;4;12
2018;4;WZ08-56;Caterer;37;10;2;12
2018;5;WZ08-56;Caterer;50;12;7;19
2018;6;WZ08-56;Caterer;52;14;3;17
2018;7;WZ08-56;Caterer;79;10;3;13
2018;8;WZ08-56;Caterer;55;12;3;15
2018;9;WZ08-56;Caterer;107;16;4;20
2018;10;WZ08-56;Caterer;51;8;8;16
2018;11;WZ08-56;Caterer;16;6;3;9
2018;12;WZ08-56;Caterer;8;6;2;8
2018;1;WZ08-55;Hotels;317;39;8;47
2018;2;WZ08-55;Hotels;24;12;6;18
2018;3;WZ08-55;Hotels;162;30;6;36
2018;4;WZ08-55;Hotels;192;18;6;24
2018;5;WZ08-55;Hotels;90;30;3;33
2018;6;WZ08-55;Hotels;243;24;2;26
2018;7;WZ08-55;Hotels;396;20;9;29
2018;8;WZ08-55;Hotels;99;38;3;41
2018;9;WZ08-55;Hotels;183;31;6;37
2018;10;WZ08-55;Hotels;78;18;3;21
2018;11;WZ08-55;Hotels;9;3;13;16
2018;12;WZ08-55;Hotels;;3;5;8
2018;1;WZ08-56;Restaurants & Cafes;1008;287;89;376
2018;2;WZ08-56;Restaurants & Cafes;1655;331;112;443
2018;3;WZ08-56;Restaurants & Cafes;923;287;110;397
2018;4;WZ08-56;Restaurants & Cafes;1206;279;105;384
2018;5;WZ08-56;Restaurants & Cafes;974;267;74;341
2018;6;WZ08-56;Restaurants & Cafes;1329;329;64;393
2018;7;WZ08-56;Restaurants & Cafes;961;321;104;425
2018;8;WZ08-56;Restaurants & Cafes;1302;280;88;368
2018;9;WZ08-56;Restaurants & Cafes;984;309;117;426
2018;10;WZ08-56;Restaurants & Cafes;948;303;99;402
2018;11;WZ08-56;Restaurants & Cafes;1128;303;115;418
2018;12;WZ08-56;Restaurants & Cafes;1442;282;104;386
2019;1;WZ08-56;Bars & Clubs;140;32;15;47
2019;2;WZ08-56;Bars & Clubs;129;18;18;36
2019;3;WZ08-56;Bars & Clubs;56;27;10;37
2019;4;WZ08-56;Bars & Clubs;58;20;8;28
2019;5;WZ08-56;Bars & Clubs;42;29;24;53
2019;6;WZ08-56;Bars & Clubs;72;29;14;43
2019;7;WZ08-56;Bars & Clubs;59;28;10;38
2019;8;WZ08-56;Bars & Clubs;69;45;26;71
2019;9;WZ08-56;Bars & Clubs;46;26;13;39
2019;10;WZ08-56;Bars & Clubs;125;31;11;42
2019;11;WZ08-56;Bars & Clubs;70;20;4;24
2019;12;WZ08-56;Bars & Clubs;70;20;4;24
2019;1;WZ08-56;Caterer;55;10;5;15
2019;2;WZ08-56;Caterer;109;7;1;8
2019;3;WZ08-56;Caterer;32;11;3;14
2019;4;WZ08-56;Caterer;93;15;4;19
2019;5;WZ08-56;Caterer;41;9;2;11
2019;6;WZ08-56;Caterer;48;11;1;12
2019;7;WZ08-56;Caterer;12;7;2;9
2019;8;WZ08-56;Caterer;27;9;3;12
2019;9;WZ08-56;Caterer;54;6;5;11
2019;10;WZ08-56;Caterer;244;8;3;11
2019;11;WZ08-56;Caterer;306;9;1;10
2019;12;WZ08-56;Caterer;306;9;1;10
2019;1;WZ08-55;Hotels;26;8;11;19
2019;2;WZ08-55;Hotels;70;11;8;19
2019;3;WZ08-55;Hotels;396;33;6;39
2019;4;WZ08-55;Hotels;318;32;3;35
2019;5;WZ08-55;Hotels;61;14;;14
2019;6;WZ08-55;Hotels;272;29;12;41
2019;7;WZ08-55;Hotels;26;12;18;30
2019;8;WZ08-55;Hotels;90;21;9;30
2019;9;WZ08-55;Hotels;110;18;3;21
2019;10;WZ08-55;Hotels;81;24;;24
2019;11;WZ08-55;Hotels;6;6;3;9
2019;12;WZ08-55;Hotels;6;6;3;9
2019;1;WZ08-56;Restaurants & Cafes;1179;331;122;453
2019;2;WZ08-56;Restaurants & Cafes;998;313;98;411
2019;3;WZ08-56;Restaurants & Cafes;1130;322;110;432
2019;4;WZ08-56;Restaurants & Cafes;1158;315;97;412
2019;5;WZ08-56;Restaurants & Cafes;1480;321;88;409
2019;6;WZ08-56;Restaurants & Cafes;1203;284;88;372
2019;7;WZ08-56;Restaurants & Cafes;835;350;64;414
2019;8;WZ08-56;Restaurants & Cafes;1012;278;97;375
2019;9;WZ08-56;Restaurants & Cafes;1165;259;114;373
2019;10;WZ08-56;Restaurants & Cafes;1273;279;87;366
2019;11;WZ08-56;Restaurants & Cafes;2232;285;45;330
2019;12;WZ08-56;Restaurants & Cafes;2232;285;45;330
2020;1;WZ08-56;Bars & Clubs;134;29;13;42
2020;2;WZ08-56;Bars & Clubs;90;22;12;34
2020;3;WZ08-56;Bars & Clubs;123;31;16;47
2020;4;WZ08-56;Bars & Clubs;58;21;27;48
2020;5;WZ08-56;Bars & Clubs;105;21;16;37
2020;6;WZ08-56;Bars & Clubs;62;19;7;26
2020;7;WZ08-56;Bars & Clubs;73;23;18;41
2020;8;WZ08-56;Bars & Clubs;23;20;15;35
2020;9;WZ08-56;Bars & Clubs;30;22;10;32
2020;10;WZ08-56;Bars & Clubs;32;16;9;25
2020;11;WZ08-56;Bars & Clubs;69;13;12;25
2020;12;WZ08-56;Bars & Clubs;14;16;7;23
2020;1;WZ08-56;Caterer;45;11;3;14
2020;2;WZ08-56;Caterer;178;14;4;18
2020;3;WZ08-56;Caterer;3;5;4;9
2020;4;WZ08-56;Caterer;40;9;2;11
2020;5;WZ08-56;Caterer;57;12;4;16
2020;6;WZ08-56;Caterer;123;8;1;9
2020;7;WZ08-56;Caterer;225;7;3;10
2020;8;WZ08-56;Caterer;2;2;4;6
2020;9;WZ08-56;Caterer;150;6;1;7
2020;10;WZ08-56;Caterer;126;11;1;12
2020;11;WZ08-56;Caterer;71;9;;9
2020;12;WZ08-56;Caterer;75;6;;6
2020;1;WZ08-55;Hotels;108;30;;30
2020;2;WZ08-55;Hotels;135;24;6;30
2020;3;WZ08-55;Hotels;11;9;5;14
2020;4;WZ08-55;Hotels;413;20;3;23
2020;5;WZ08-55;Hotels;230;26;9;35
2020;6;WZ08-55;Hotels;518;36;5;41
2020;7;WZ08-55;Hotels;306;15;3;18
2020;8;WZ08-55;Hotels;336;18;3;21
2020;9;WZ08-55;Hotels;628;22;12;34
2020;10;WZ08-55;Hotels;669;20;;20
2020;11;WZ08-55;Hotels;192;24;12;36
2020;12;WZ08-55;Hotels;174;26;9;35
2020;1;WZ08-56;Restaurants & Cafes;1046;279;106;385
2020;2;WZ08-56;Restaurants & Cafes;1294;264;76;340
2020;3;WZ08-56;Restaurants & Cafes;1312;272;76;348
2020;4;WZ08-56;Restaurants & Cafes;828;210;116;326
2020;5;WZ08-56;Restaurants & Cafes;1583;250;78;328
2020;6;WZ08-56;Restaurants & Cafes;377;258;106;364
2020;7;WZ08-56;Restaurants & Cafes;327;211;108;319
2020;8;WZ08-56;Restaurants & Cafes;1158;150;108;258
2020;9;WZ08-56;Restaurants & Cafes;1093;168;78;246
2020;10;WZ08-56;Restaurants & Cafes;679;173;77;250
2020;11;WZ08-56;Restaurants & Cafes;743;200;71;271
2020;12;WZ08-56;Restaurants & Cafes;897;169;78;247
2021;1;WZ08-56;Bars & Clubs;57;14;10;24
2021;2;WZ08-56;Bars & Clubs;47;13;4;17
2021;3;WZ08-56;Bars & Clubs;52;27;10;37
2021;4;WZ08-56;Bars & Clubs;70;20;7;27
2021;5;WZ08-56;Bars & Clubs;54;23;10;33
2021;6;WZ08-56;Bars & Clubs;25;15;5;20
2021;7;WZ08-56;Bars & Clubs;24;15;7;22
2021;8;WZ08-56;Bars & Clubs;27;7;13;20
2021;9;WZ08-56;Bars & Clubs;26;14;2;16
2021;10;WZ08-56;Bars & Clubs;4;10;9;19
2021;11;WZ08-56;Bars & Clubs;4;17;8;25
2021;12;WZ08-56;Bars & Clubs;32;26;8;34
2021;1;WZ08-56;Caterer;37;8;3;11
2021;2;WZ08-56;Caterer;11;8;2;10
2021;3;WZ08-56;Caterer;179;6;3;9
2021;4;WZ08-56;Caterer;67;7;2;9
2021;5;WZ08-56;Caterer;1;3;1;4
2021;6;WZ08-56;Caterer;52;11;3;14
2021;7;WZ08-56;Caterer;22;10;3;13
2021;8;WZ08-56;Caterer;9;4;3;7
2021;9;WZ08-56;Caterer;32;8;2;10
2021;10;WZ08-56;Caterer;49;6;3;9
2021;11;WZ08-56;Caterer;30;8;2;10
2021;12;WZ08-56;Caterer;18;4;1;5
2021;1;WZ08-55;Hotels;527;27;3;30
2021;2;WZ08-55;Hotels;180;36;;36
2021;3;WZ08-55;Hotels;460;39;15;54
2021;4;WZ08-55;Hotels;18;15;5;20
2021;5;WZ08-55;Hotels;9;24;3;27
2021;6;WZ08-55;Hotels;153;18;;18
2021;7;WZ08-55;Hotels;10;8;;8
2021;8;WZ08-55;Hotels;2;5;5;10
2021;9;WZ08-55;Hotels;90;6;3;9
2021;10;WZ08-55;Hotels;;6;;6
2021;11;WZ08-55;Hotels;;5;9;14
2021;12;WZ08-55;Hotels;36;9;3;12
2021;1;WZ08-56;Restaurants & Cafes;1055;181;106;287
2021;2;WZ08-56;Restaurants & Cafes;324;171;72;243
2021;3;WZ08-56;Restaurants & Cafes;451;224;96;320
2021;4;WZ08-56;Restaurants & Cafes;990;186;85;271
2021;5;WZ08-56;Restaurants & Cafes;438;141;90;231
2021;6;WZ08-56;Restaurants & Cafes;358;185;68;253
2021;7;WZ08-56;Restaurants & Cafes;481;185;87;272
2021;8;WZ08-56;Restaurants & Cafes;256;142;66;208
2021;9;WZ08-56;Restaurants & Cafes;306;178;41;219
2021;10;WZ08-56;Restaurants & Cafes;337;120;82;202
2021;11;WZ08-56;Restaurants & Cafes;685;180;32;212
2021;12;WZ08-56;Restaurants & Cafes;382;123;43;166
2022;1;WZ08-56;Bars & Clubs;24;17;10;27
2022;2;WZ08-56;Bars & Clubs;22;16;10;26
2022;3;WZ08-56;Bars & Clubs;12;5;5;10
2022;4;WZ08-56;Bars & Clubs;18;20;6;26
2022;5;WZ08-56;Bars & Clubs;6;15;3;18
2022;6;WZ08-56;Bars & Clubs;;12;7;19
2022;7;WZ08-56;Bars & Clubs;9;18;6;24
2022;8;WZ08-56;Bars & Clubs;2;6;5;11
2022;1;WZ08-56;Caterer;29;3;7;10
2022;2;WZ08-56;Caterer;49;7;3;10
2022;3;WZ08-56;Caterer;13;5;2;7
2022;4;WZ08-56;Caterer;35;9;4;13
2022;5;WZ08-56;Caterer;88;5;1;6
2022;6;WZ08-56;Caterer;50;5;2;7
2022;7;WZ08-56;Caterer;12;6;1;7
2022;8;WZ08-56;Caterer;54;4;3;7
2022;1;WZ08-55;Hotels;;6;;6
2022;2;WZ08-55;Hotels;;2;6;8
2022;3;WZ08-55;Hotels;;3;3;6
2022;4;WZ08-55;Hotels;;;6;6
2022;5;WZ08-55;Hotels;1302;6;6;12
2022;6;WZ08-55;Hotels;20;8;11;19
2022;7;WZ08-55;Hotels;12;12;3;15
2022;8;WZ08-55;Hotels;150;9;3;12
2022;1;WZ08-56;Restaurants & Cafes;281;104;60;164
2022;2;WZ08-56;Restaurants & Cafes;261;161;51;212
2022;3;WZ08-56;Restaurants & Cafes;628;195;91;286
2022;4;WZ08-56;Restaurants & Cafes;470;160;48;208
2022;5;WZ08-56;Restaurants & Cafes;283;155;56;211
2022;6;WZ08-56;Restaurants & Cafes;426;151;63;214
2022;7;WZ08-56;Restaurants & Cafes;539;150;64;214
2022;8;WZ08-56;Restaurants & Cafes;613;147;53;200